5 15
|-------------|
|.F.|..-...-..|
|..-|.@..P..-.|
|.F....-.--...|
|-------------|